111111111
100300301
100000001
101120001
102020001
100000001
100P00001
111111111

